000000000000000000000000000000000000000000000000000000000000000000000000000000000000000000000000000000000000000000000000
000000000000000000000000000000000000000000000000000000000000000000000000000000000000000000000000000000000000000000000000
000000000000000000000000000000000000000000000000000000000000000000000000000000000000000000000000000000000000000000000000
000000000000000000000000000000000000000000000000000000000000000000000000000000000000000000000000000000000000000000000000
000000000000000000000000000000000000000000000000000000000000000000000000000000000000000000000000000000000000000000000000
000000000000000000000000000000000000000000000000000000000000000000000000000000000000000000000000000000000000000000000000
000000000000000000000000000000000067000000000000000000000000000000000000000000000000000000000000000000000000000000000000
000000000000000000000000000000006513000000000000000000000000000000000000000000000000000000000000000000000000000000000000
000000000000000000000000000000061111555700000000000000000000000000000000000000000000000000000000000000000000000000000000
000000000000000000000000000006511111111170000000000000000000000000000000000000000000000000000000000000000000000000000000
000000000000000000000000000651111111111130000000000000000000000000000000000000000000000000000000000000000000000000000000
000000000000000000000000006111111111111130000000000000000000000000000000000000000000000000000000000000000000000000000000
000000000000000000000000651111111111111117000000000000000000000000000000000000000000000000000000000000000000000000000000
000000000000000000000006111111111111111111700000000000000000000000000000000000000000000000000000000000000000000000000000
000000000000000000000061111111111111111111157000000000000000000000000000000000000000000000000000000000000000000000000000
000000000000000000000611111111111111111111111700000000000000000000000000000000000000000000000000000000000000000000000000
000000000000000000006111111111111111111111111300000000000000000657000000000000000000000000000000000000000000000000000000
000000000000000000061111111111111111111111111157000000000000065111570000000000000000000000000000000000000000000000000000
000000000000000000611111111111111111111111111113000000000000021111130000000000000000000000000000000000000000000000000000
000000000000000006111111111111111111111111111149000000000000611111130000000000000000000000000000000000000000000000000000
0000000000000000611111111111111111111111111449006110000000006111111117000000000000000000000000000000000000000000000000000
000000000000000611111111111111111111111111300006300000000061111111113000000000000000000000000000000000000000000000000000
000000000000006111111111111111111111111111300002300000000611111111111700000000000000000000000000000000000000000000000000
000000000000061111111111111111111111111111170651170000006111111111111157000000000000000000000000000000000000000000000000
000000000000611111111111111111111111111111115111117000002111111111111111700000000000000000000000000000000000000000000000
000000000000211111111111111111111111111111111114113000002111111111111111300000000000000000000000000000000000000000000000
000000000006111111111111111111111111111111111130811570002111111111111111900000000000000000000000000000000000000000000000
000000000061111111111111111111111111111111111130021115551111111111111113000000000000000000000000000000000000000000000000
000000000021111111111111111111111111111111111117021111111111111111111111700000000000000000000000000000000000000000000000
000000000611111111111111111111111111111111111111511111111111111111111111157000000000000000000000000000000000000000000000
000000000211111111111111111111111111111111111111111111111111111111111111111570000000000000000000000000000000000000000000
000000006111111111111111111111111111111111111111111111111111111111111111111130000000000000000000000000000000000000000000
000000002111111111111111111111111111111111111111111111111111111111111111111115700000000000000000000000000000000000000000
000000002111111111111111111111111111111111111111111111111111111111111111111111900000000000000000000000000000000000000000
000000061111111111111111111111111111111111111111111111111111111111111111111113000000000000000000000000000000000000000000
000000021111111111111111111111111111111111111111111111111111111111111111111113000000000000000000000000000000000000000000
000000081111111111111111111111111111111111111111111111111111111111111111111149000000000000000000000000000000000000000000
000000002111111111111111111111111111111114111111111111111111111111111111144900000000000000000000000000000000000000000000
000000002111111111111111111111111111114490811111111111111111111111111111900000000000000000000000000000000000000000000000
000000002111111111111111111111111111490000081111111111111111111111111113000000000000000000000000000000000000000000000000
000000008111111111111111111111111113000000002111111111111111111111111113000000000000000000000000000000000000000000000000
000000000211111111111111111111111113000000008111111111111111111111111119000000000000000000000000000000000000000000000000
000000000811111111144411111111111111700000000211111111111111111111111190000000000000000000000000000000000000000000000000
000000000021111111300021111111111111155700670211111111444441111111111300000000000000000000000000000000000000000000000000
000000000081111111300021111111111111111300215111111119000008111111144900000000000000000000000000000000000000000000000000
000000000002111111300081111111111111111170211111111190000000811111900000000000000000000000000000000000000000000000000000
000000000002111141300002111111111111111130211111111900000000021119000000000000000000000000000000000000000000000000000000
000000000061111308900002111111111111111115111111119000000000084430000000000000000000000000000000000000000000000000000000
00000016006114449000000021111111111111111111111111900000000000000140000000000000000000000000000000000000000000000000000000
000000000213000000000061111111111111111111444444900000000000000000000000000000000000000000000000000000000000000000000000
000000000813000000000021111111111111111113000000000000000000000000000000000000000000000000000000000000000000000000000000
0000000000290000000006111111111111111111111100000000000000000000000000000000000000000000000000000000000000000000000000000
0000000000140000000000211111111111111111113000000000000000000000000000000000000000000000000000000000000000000000000000000
000000000000000000006111111111111111111113000000000000000000000000000000000000000000000000000000000000000000000000000000
0000000000000000000101111111111111111111111700000000000000000000000000000000000000000000000000000000000000000000000000000
0000000000000000000081111111111111111111111110000000000000000000000000000000000000000000000000000000000000000000000000000
000000000000000000000811111111111111111111300000000000000000000000000000000000000000000000000000000000000000000000000000
000000000000000000000021111111111111111111300000000000000000000000000000000000000000000000000000000000000000000000000000
0000000000000000000000211111111111111111111110000000000000000000000000000000000000000000000000000000000000000000000000000
000000000000000000000081111111111111111111300000000000000000000000000000000000000000000000000000000000000000000000000000
0000000000000000000000081111111111111111111110000000000000000000000000000000000000000000000000000000000000000000000000000
000000000000000000000000211111111111111111300000000000000000000000000000000000000000000000000000000000000000000000000000
000000000000000000000000811111111111111111900000000000000000000000000000000000000000000000000000000000000000000000000000
000000000000000000000000021111111111111113000000000000000000000000000000000000000000000000000000000000000000000000000000
000000000000000000000000021111111111111419000000000000000000000000000000000000000000000000000000000000000000000000000000
0000000000000000000000000811111111111190150000000000000000000000000000000000000000000000000000000000000000000000000000000
0000000000000000000000000084444411111300150000000000000000000000000000000000000000000000000000000000000000000000000000000
000000000000000000000000000000008111115530000000000000000000000000000000000000000000000000000000000000000000000000000000
000000000000000000000000000000000811111190000000000000000000000000000000000000000000000000000000000000000000000000000000
000000000000000000000000000000000021111300000000000000000000000000000000000000000000000000000000000000000000000000000000
000000000000000000000000000000000021111300000000000000000000000000000000000000000000000000000000000000000000000000000000
0000000000000000000000000000000001011114900000000000000000000000000000000000000000000000000000000000000000000000000000000
000000000000000000000000000000000021190000000000000000000000000000000000000000000000000000000000000000000000000000000000
000000000000000000000000000000000611900000000000000000000000000000000000000000000000000000000000000000000000000000000000
000000000000000000000000000000000849000000000000000000000000000000000000000000000000000000000000000000000000000000000000
000000000000000000000000000000000000000000000000000000000000000000000000000000000000000000000000000000000000000000000000
000000000000000000000000000000000000000000000000000000000000000000000000000000000000000000000000000000000000000000000000
000000000000000000000000000000000000000000000000000000000000000000000000000000000000000000000000000000000000000000000000
000000000000000000000000000000000000000000000000000000000000000000000000000000000000000000000000000000000000000000000000
000000000000000000000000000000000000000000000000000000000000000000000000000000000000000000000000000000000000000000000000
000000000000000000000000000000000000000000000000000000000000000000000000000000000000000000000000000000000000000000000000
000000000000000000000000000000000000000000000000000000000000000000000000000000000000000000000000000000000000000000000000
000000000000000000000000000000000000000000000000000000000000000000000000000000000000000000000000000000000000000000000000
000000000000000000000000000000000000000000000000000000000000000000000000000000000000000000000000000000000000000000000000
000000000000000000000000000000000000000000000000000000000000000000000000000000000000000000000000000000000000000000000000
000000000000000000000000000000000000000000000000000000000000000000000000000000000000000000000000000000000000000000000000
000000000000000000000000000000000000000000000000000000000000000000000000000000000000000000000000000000000000000000000000
000000000000000000000000000000000000000000000000000000000000000000000000000000000000000000000000000000000000000000000000
000000000000000000000000000000000000000000000000000000000000000000000000000000000000000000000000000000000000000000000000
000000000000000000000000000000000000000000000000000000000000000000000000000000000000000000000000000000000000000000000000
000000000000000000000000000000000000000000000000000000000000000000000000000000000000000000000000000000000000000000000000
000000000000000000000000000000000000000000000000000000000000000000000000000000000000000000000000000000000000000000000000
000000000000000000000000000000000000000000000000000000000000000000000000000000000000000000000000000000000000000000000000
000000000000670000000000000000000000000000000000000000000000000000000000000000000000000000000000000000000000000000000000
000000000000217000000000000000000000000000000000000000000000000000000000000000000000000000000000000000000000000000000000
000000000000213000000000000000000000000000000000000000000000000000000000000000000000000000000000000000000000000000000000
000000000000811706700000000000000000000000000000000000000000000000000000000000000000000000000000000000000000000000000000
000000000000081151170000000000000000000000000000000000000000000000000000000000000000000000000000000000000000000000000000
000000000000008111190000000000000000000000000000000000000000000000000000000000000000000000000000000000000000000000000000
000000000000000841300000000000000000000000000000000000000000000000000000000000000000000000000000000000000000000000000000
0000000000000000081511000000000000000000000000000000000000000000000000000000000000000000000000000000000000000000000000000
0000000000000000002301600000000000000000000000000000000000000000000000000000000000000000000000000000000000000000000000000
000000000000000000817000000000000000000000000000000000000000000000000000000000000000000000000000000000000000000000000000
000000000000000000083000000000000000000000000000000000000000000000000000000000000000000000000000000000000000000000000000
0000000000000000000014000000000000000000000000000000000000000000000000000000000000000000000000000000000000000000000000000
000000000000000000000000000000000000000000000000000000000000000000000000000000000000000000000000000000000000000000000000
000000000000000000000000000000000000000000000000000000000000000000000000000000000000000000000000000000000000000000000000
000000000000000000000000000000000000000000000000000000000000000000000000000000000000000000000000000000000000000000000000
000000000000000000000000000000000000000000000000000000000000000000000000000000000000000000000000000000000000000000000000
000000000000000000000000000000000000000000000000000000000000000000000000000000000000000000000000000000000000000000000000
000000000000000000000000000000000000000000000000000000000000000000000000000000000000000000000000000000000000000000000000
000000000000000000000000000000000000000000000000000000000000000000000000000000000000000000000000000000000000000000000000
000000000000000000000000000000000000000000000000000000000000000000000000000000000000000000000000000000000000000000000000
000000000000000000000000000000000000000000000000000000000000000000000000000000000000000000000000000000000000000000000000
000000000000000000000000000000000000000000000000000000000000000000000000000000000000000000000000000000000000000000000000
000000000000000000000000000000000000000000000000000000000000000000000000000000000000000000000000000000000000000000000000
000000000000000000000000000000000000000000000000000000000000000000000000000000000000000000000000000000000000000000000000
000000000000000000000000000000000000000000000000000000000000000000000000000000000000000000000000000000000000000000000000
000000000000000000000000000000000000000000000000000000000000000000000000000000000000000000000000000000000000000000000000
000000000000000000000000000000000000000000000000000000000000000000000000000000000000000000000000000000000000000000000000
